Id2,Estimate; Total:,Estimate; Women who had a birth in the past 12 months:,"Estimate; Women who had a birth in the past 12 months: - Unmarried (never married, widowed, and divorced):","Estimate; Women who had a birth in the past 12 months: - Unmarried (never married, widowed, and divorced): - 15 to 19 years old",Estimate; Women who did not have a birth in the past 12 months:
73430,196,23,14,0,173
73931,137,17,0,0,120
73949,370,16,3,0,354
75020,4586,438,165,0,4148
75021,1525,115,14,14,1410
75058,691,43,4,0,648
75076,1287,33,23,0,1254
75090,5910,555,314,72,5355
75092,5677,183,17,1,5494
75101,143,9,6,0,134
75102,310,84,0,0,226
75103,2569,128,42,0,2441
75105,24,0,0,0,24
75109,871,40,0,0,831
75110,6614,607,227,108,6007
75117,656,45,7,7,611
75119,6451,435,214,10,6016
75124,866,54,16,7,812
75127,429,49,0,0,380
75135,1529,65,44,3,1464
75140,1402,141,65,0,1261
75144,583,14,12,0,569
75148,1236,27,9,0,1209
75152,1171,45,4,0,1126
75153,100,0,0,0,100
75155,684,48,11,0,636
75156,3127,201,60,6,2926
75163,283,16,16,0,267
75165,10287,718,234,0,9569
75167,2436,84,0,0,2352
75401,4489,179,63,0,4310
75402,3275,215,79,19,3060
75410,619,53,38,0,566
75411,195,24,16,0,171
75412,89,0,0,0,89
75413,37,3,3,0,34
75414,707,60,12,3,647
75415,8,0,0,0,8
75416,560,64,40,0,496
75417,448,10,0,0,438
75418,2299,110,100,64,2189
75420,194,9,0,0,185
75421,282,0,0,0,282
75422,553,11,0,0,542
75423,586,51,0,0,535
75426,1154,5,5,0,1149
75428,3263,107,71,14,3156
75431,405,58,50,0,347
75432,745,52,18,0,693
75433,622,15,3,0,607
75435,452,42,30,0,410
75436,414,39,12,12,375
75437,227,26,20,9,201
75438,193,27,3,3,166
75439,283,9,4,0,274
75440,1265,76,60,0,1189
75441,0,0,0,0,0
75446,722,19,0,0,703
75447,291,8,0,0,283
75448,90,45,17,7,45
75449,205,36,9,0,169
75450,87,0,0,0,87
75451,85,0,0,0,85
75453,682,16,0,0,666
75455,6643,480,111,12,6163
75457,1327,12,0,0,1315
75459,1168,30,26,0,1138
75460,5464,319,228,61,5145
75462,2612,48,0,0,2564
75468,95,5,5,0,90
75469,92,21,10,0,71
75470,56,0,0,0,56
75471,291,49,14,2,242
75472,612,70,26,3,542
75473,680,26,0,0,654
75475,21,0,0,0,21
75476,265,11,6,0,254
75477,149,16,4,0,133
75478,187,34,10,0,153
75479,388,5,3,0,383
75480,409,0,0,0,409
75481,52,7,0,0,45
75482,5546,435,52,0,5111
75486,443,22,0,0,421
75487,315,0,0,0,315
75488,144,0,0,0,144
75489,202,17,0,0,185
75490,475,13,5,0,462
75492,86,2,0,0,84
75493,142,8,3,0,134
75494,1810,189,71,0,1621
75496,825,38,26,0,787
75497,423,16,16,0,407
75501,8284,444,281,12,7840
75503,5741,495,141,87,5246
75550,191,6,6,4,185
75551,2476,81,34,25,2395
75554,356,0,0,0,356
75555,230,11,0,0,219
75556,203,21,13,0,182
75558,449,0,0,0,449
75559,1065,53,9,0,1012
75560,135,3,0,0,132
75561,1284,57,21,5,1227
75562,0,0,0,0,0
75563,845,28,0,0,817
75565,96,5,0,0,91
75566,58,0,0,0,58
75567,1206,106,42,0,1100
75568,523,14,14,0,509
75569,807,180,50,50,627
75570,1944,186,73,36,1758
75571,555,79,0,0,476
75572,1011,56,29,6,955
75573,0,0,0,0,0
75574,345,17,14,0,328
75601,3861,299,111,9,3562
75602,5489,397,283,63,5092
75603,1056,82,0,0,974
75604,7421,388,122,13,7033
75605,6542,484,98,58,6058
75630,289,16,16,16,273
75631,603,35,4,0,568
75633,3270,194,123,0,3076
75638,1345,97,32,0,1248
75639,652,0,0,0,652
75640,894,34,0,0,860
75641,99,0,0,0,99
75642,14,0,0,0,14
75643,455,15,11,0,440
75644,2394,209,73,0,2185
75645,2210,39,8,0,2171
75647,2885,197,96,11,2688
75650,1538,20,20,0,1518
75651,601,28,14,0,573
75652,3349,172,111,43,3177
75654,2617,193,67,0,2424
75656,889,24,12,6,865
75657,1715,33,16,0,1682
75661,522,7,0,0,515
75662,6474,309,176,38,6165
75667,204,5,0,0,199
75668,416,40,22,14,376
75669,123,23,0,0,100
75670,4517,413,157,31,4104
75672,3403,283,175,0,3120
75681,466,17,4,0,449
75682,124,0,0,0,124
75683,819,61,21,0,758
75684,1792,209,48,12,1583
75686,3074,257,145,7,2817
75691,538,33,5,0,505
75692,1039,0,0,0,1039
75693,1711,85,44,0,1626
75701,10003,454,285,0,9549
75702,7023,703,412,63,6320
75703,9099,402,75,0,8697
75704,2028,55,25,0,1973
75705,557,23,21,0,534
75706,2178,270,159,0,1908
75707,3402,206,33,0,3196
75708,1896,131,2,0,1765
75709,1397,38,1,0,1359
75750,917,99,81,77,818
75751,3619,260,57,0,3359
75752,1593,99,12,0,1494
75754,1307,81,35,0,1226
75755,1312,58,22,0,1254
75756,1013,91,9,0,922
75757,2421,24,5,5,2397
75758,1645,62,19,0,1583
75759,8,2,0,0,6
75760,414,3,0,0,411
75762,2637,166,10,10,2471
75763,1238,37,12,0,1201
75764,45,0,0,0,45
75765,1315,107,74,3,1208
75766,5799,365,163,13,5434
75770,615,43,0,0,572
75771,4233,125,51,0,4108
75773,2802,172,0,0,2630
75778,728,45,0,0,683
75779,37,0,0,0,37
75780,68,0,0,0,68
75783,1389,65,16,7,1324
75784,158,4,0,0,154
75785,1953,117,44,0,1836
75788,54,0,0,0,54
75789,1558,58,45,3,1500
75790,1002,110,58,18,892
75791,3233,286,15,0,2947
75792,602,3,0,0,599
75801,3563,310,156,24,3253
75803,3307,283,95,36,3024
75831,1310,99,19,19,1211
75832,52,0,0,0,52
75833,682,9,3,3,673
75835,2329,121,25,4,2208
75838,60,0,0,0,60
75839,1088,26,0,0,1062
75840,1516,11,0,0,1505
75844,1163,33,20,0,1130
75845,874,27,9,9,847
75846,704,49,22,12,655
75847,386,4,2,0,382
75848,29,0,0,0,29
75849,16,0,0,0,16
75850,136,83,83,0,53
75851,378,5,3,3,373
75852,233,0,0,0,233
75853,154,0,0,0,154
75855,380,20,3,0,360
75856,0,0,0,0,0
75858,0,0,0,0,0
75859,434,35,21,0,399
75860,1041,37,20,0,1004
75861,381,39,19,0,342
75862,1643,45,2,0,1598
75901,7193,414,128,21,6779
75904,8362,589,182,12,7773
75925,910,12,8,0,898
75926,287,8,0,0,279
75928,248,0,0,0,248
75929,393,41,0,0,352
75930,297,0,0,0,297
75931,536,3,2,0,533
75932,166,0,0,0,166
75933,154,0,0,0,154
75934,6,0,0,0,6
75935,3054,395,189,0,2659
75936,216,22,0,0,194
75937,188,11,5,5,177
75938,483,40,18,8,443
75939,898,66,44,14,832
75941,1995,76,26,7,1919
75942,90,0,0,0,90
75943,256,14,7,0,242
75944,310,26,18,9,284
75946,525,30,17,0,495
75948,1206,72,0,0,1134
75949,1621,65,4,0,1556
75951,3003,181,112,0,2822
75954,795,49,19,0,746
75956,1626,25,0,0,1601
75959,85,0,0,0,85
75960,156,4,0,0,152
75961,3842,249,119,9,3593
75962,1918,0,0,0,1918
75964,4646,308,91,8,4338
75965,5794,236,87,14,5558
75966,1018,37,1,0,981
75968,357,29,29,0,328
75969,948,16,5,0,932
75972,1089,44,9,0,1045
75973,491,21,0,0,470
75974,709,15,12,0,694
75975,787,64,46,21,723
75976,223,22,2,2,201
75977,324,0,0,0,324
75978,13,0,0,0,13
75979,1782,90,39,0,1692
75980,587,27,12,0,560
76001,8117,544,131,0,7573
76002,10384,622,235,25,9762
76006,7005,553,287,22,6452
76008,3753,94,34,0,3659
76009,5257,367,157,62,4890
76010,15525,1071,521,68,14454
76011,6580,406,277,33,6174
76012,6462,334,136,13,6128
76013,7678,413,124,0,7265
76014,9159,957,583,50,8202
76015,4332,41,22,0,4291
76016,7454,413,78,16,7041
76017,11423,485,136,1,10938
76018,7834,354,129,10,7480
76020,5595,405,195,58,5190
76021,8587,483,72,0,8104
76022,3028,198,63,44,2830
76023,1293,152,58,6,1141
76028,16164,1171,280,81,14993
76031,4079,232,59,23,3847
76033,5687,348,58,0,5339
76034,5118,230,20,0,4888
76035,409,5,0,0,404
76036,5677,283,135,0,5394
76039,9259,422,97,0,8837
76040,8182,524,136,97,7658
76041,58,10,0,0,48
76043,1721,178,74,0,1543
76044,780,22,12,0,758
76048,4779,290,53,31,4489
76049,4258,364,53,19,3894
76050,1373,73,15,0,1300
76053,7241,407,219,20,6834
76054,2399,128,23,0,2271
76055,496,68,8,0,428
76058,3950,218,133,40,3732
76059,1324,131,39,10,1193
76060,1770,83,12,0,1687
76061,0,0,0,0,0
76063,17352,876,173,0,16476
76064,381,0,0,0,381
76065,7528,483,109,0,7045
76066,621,15,0,0,606
76067,4573,247,79,0,4326
76070,184,0,0,0,184
76071,813,44,5,0,769
76073,1206,123,0,0,1083
76077,37,0,0,0,37
76082,4234,231,85,60,4003
76084,1739,132,51,0,1607
76085,2265,66,7,7,2199
76086,5482,362,18,2,5120
76087,5703,199,38,20,5504
76088,2657,221,84,1,2436
76093,392,57,20,0,335
76102,2551,185,166,47,2366
76103,3512,178,129,0,3334
76104,4069,345,156,30,3724
76105,5482,542,268,66,4940
76106,9198,1007,761,54,8191
76107,7293,349,125,37,6944
76108,9989,565,135,8,9424
76109,6136,250,63,0,5886
76110,7989,516,170,0,7473
76111,5826,439,221,39,5387
76112,10614,830,516,92,9784
76114,5810,337,55,14,5473
76115,5541,314,86,16,5227
76116,12527,610,295,16,11917
76117,7528,602,247,75,6926
76118,3691,282,28,0,3409
76119,10865,807,417,161,10058
76120,5332,426,373,33,4906
76123,8527,377,109,41,8150
76126,4335,334,84,1,4001
76127,1192,89,79,0,1103
76129,1752,0,0,0,1752
76131,9426,361,166,0,9065
76132,7200,568,245,2,6632
76133,12426,966,410,54,11460
76134,6708,727,505,42,5981
76135,5065,340,164,98,4725
76137,16057,804,193,0,15253
76140,7631,480,164,40,7151
76148,6167,356,65,0,5811
76155,1626,169,19,0,1457
76164,3981,447,264,95,3534
76179,14388,645,74,25,13743
76180,8767,312,204,47,8455
76182,6931,327,48,0,6604
76225,742,28,0,0,714
76228,171,2,0,0,169
76230,1953,166,4,0,1787
76233,841,31,0,0,810
76238,94,9,0,0,85
76239,215,4,0,0,211
76240,5974,522,153,11,5452
76244,19937,1215,335,56,18722
76245,242,37,0,0,205
76248,8638,425,32,0,8213
76250,206,3,0,0,203
76251,96,4,0,0,92
76252,608,27,11,0,581
76253,92,14,14,0,78
76255,1093,138,10,0,955
76261,57,0,0,0,57
76263,5,0,0,0,5
76264,375,3,0,0,372
76265,510,42,12,0,468
76268,43,0,0,0,43
76270,226,7,0,0,219
76271,397,35,22,0,362
76273,1737,37,10,10,1700
76301,3756,331,202,53,3425
76302,3374,226,132,49,3148
76305,852,17,4,2,835
76306,3560,134,19,0,3426
76308,5431,306,83,28,5125
76309,3005,158,79,26,2847
76310,4487,208,72,18,4279
76311,1207,108,4,0,1099
76351,373,5,5,0,368
76354,2662,164,31,0,2498
76357,144,6,6,0,138
76360,789,44,44,0,745
76363,63,2,2,0,61
76364,21,0,0,0,21
76365,906,30,19,0,876
76366,517,32,6,0,485
76367,2007,183,0,0,1824
76370,55,0,0,0,55
76371,327,12,6,0,315
76372,231,17,10,0,214
76373,35,0,0,0,35
76374,733,41,18,0,692
76377,198,19,0,0,179
76379,177,13,0,0,164
76380,758,46,0,0,712
76384,2876,183,63,18,2693
76388,33,6,6,6,27
76389,246,5,3,0,241
76401,8044,385,67,35,7659
76402,379,0,0,0,379
76424,1711,99,56,10,1612
76426,2353,80,50,0,2273
76427,317,11,7,0,306
76429,17,0,0,0,17
76430,521,35,16,0,486
76431,906,56,12,0,850
76432,263,5,4,4,258
76433,280,5,0,0,275
76435,120,0,0,0,120
76436,19,0,0,0,19
76437,1190,70,53,30,1120
76442,1516,194,111,0,1322
76443,405,11,11,0,394
76444,742,14,7,0,728
76445,34,0,0,0,34
76446,1731,153,63,10,1578
76448,1013,28,0,0,985
76449,504,0,0,0,504
76450,2639,175,92,0,2464
76452,14,0,0,0,14
76453,142,17,0,0,125
76454,319,33,17,0,286
76455,188,22,3,0,166
76457,923,11,4,0,912
76458,998,82,14,2,916
76459,42,6,0,0,36
76460,139,0,0,0,139
76462,592,15,0,0,577
76463,133,16,3,0,117
76464,133,3,3,0,130
76466,40,0,0,0,40
76469,6,0,0,0,6
76470,882,5,0,0,877
76471,331,22,15,5,309
76472,345,0,0,0,345
76474,34,0,0,0,34
76475,75,0,0,0,75
76476,698,12,6,0,686
76481,52,0,0,0,52
76483,166,7,0,0,159
76484,91,5,5,5,86
76486,217,0,0,0,217
76487,597,5,0,0,592
76490,0,0,0,0,0
76491,91,3,0,0,88
76501,3870,203,88,20,3667
76502,8016,496,116,0,7520
76504,5675,418,86,32,5257
76508,0,0,0,0,0
76513,9213,349,148,66,8864
76518,295,43,14,0,252
76519,253,0,0,0,253
76520,1355,12,12,0,1343
76522,10110,605,57,9,9505
76523,0,0,0,0,0
76524,803,17,0,0,786
76525,232,18,11,5,214
76528,4907,230,174,18,4677
76531,692,49,21,0,643
76534,533,17,12,0,516
76538,199,17,12,0,182
76539,2027,25,0,0,2002
76541,4518,294,73,2,4224
76542,13386,876,160,0,12510
76543,8069,749,281,23,7320
76544,6881,695,5,0,6186
76548,7250,340,147,0,6910
76549,14821,710,203,6,14111
76550,2178,109,64,0,2069
76554,486,30,11,0,456
76556,252,22,0,0,230
76557,1108,10,0,0,1098
76559,1661,10,0,0,1651
76561,285,15,10,0,270
76565,0,0,0,0,0
76566,89,0,0,0,89
76567,1922,75,24,0,1847
76569,482,10,2,0,472
76570,521,38,36,22,483
76571,1092,28,8,0,1064
76579,937,99,4,4,838
76596,983,43,7,0,940
76597,83,3,3,0,80
76598,443,19,7,0,424
76599,1583,20,17,0,1563
76621,234,20,8,0,214
76622,254,25,7,0,229
76623,36,7,0,0,29
76624,569,12,0,0,557
76626,389,10,3,0,379
76627,350,10,5,0,340
76628,14,0,0,0,14
76629,315,4,4,0,311
76630,333,32,0,0,301
76631,123,7,1,0,116
76632,327,12,0,0,315
76633,1325,83,21,9,1242
76634,1045,39,19,0,1006
76635,211,28,19,0,183
76636,305,10,3,0,295
76637,103,4,0,0,99
76638,564,39,0,0,525
76639,258,10,7,0,248
76640,713,70,0,0,643
76641,433,24,3,0,409
76642,1332,55,10,0,1277
76643,3636,72,0,0,3564
76645,2344,198,68,33,2146
76648,543,55,3,0,488
76649,140,0,0,0,140
76650,15,2,0,0,13
76651,686,22,0,0,664
76652,228,4,0,0,224
76653,232,18,8,6,214
76654,26,0,0,0,26
76655,2009,78,44,0,1931
76656,597,36,9,2,561
76657,2014,33,20,20,1981
76660,160,10,0,0,150
76661,2425,76,41,12,2349
76664,671,23,0,0,648
76665,557,8,8,3,549
76666,52,2,0,0,50
76667,2567,77,40,5,2490
76670,313,14,9,0,299
76671,344,31,8,0,313
76673,232,15,5,2,217
76676,83,2,0,0,81
76678,51,2,0,0,49
76679,331,10,0,0,321
76680,58,0,0,0,58
76681,134,0,0,0,134
76682,544,42,8,0,502
76685,0,0,0,0,0
76686,42,3,0,0,39
76687,359,32,32,0,327
76689,859,8,0,0,851
76690,218,11,4,0,207
76691,1486,24,0,0,1462
76692,1851,115,92,20,1736
76693,275,9,7,0,266
76701,645,65,5,0,580
76704,1793,81,50,18,1712
76705,7080,603,170,18,6477
76706,11802,440,175,20,11362
76707,3996,343,171,28,3653
76708,6455,297,132,19,6158
76710,5533,369,237,57,5164
76711,2036,42,11,0,1994
76712,5623,229,53,53,5394
76798,1229,0,0,0,1229
76801,5397,118,53,24,5279
76802,1190,21,9,0,1169
76820,21,0,0,0,21
76821,929,32,21,0,897
76823,661,35,17,0,626
76824,0,0,0,0,0
76825,1511,58,36,0,1453
76827,130,3,0,0,127
76828,21,0,0,0,21
76831,39,0,0,0,39
76832,73,11,0,0,62
76834,1080,36,28,0,1044
76836,0,0,0,0,0
76837,319,41,38,0,278
76841,0,0,0,0,0
76842,9,0,0,0,9
76844,714,7,0,0,707
76845,37,0,0,0,37
76848,5,0,0,0,5
76849,706,48,13,0,658
76852,24,0,0,0,24
76853,318,33,16,16,285
76854,42,0,0,0,42
76856,599,25,13,0,574
76857,339,11,0,0,328
76858,48,0,0,0,48
76859,375,15,6,0,360
76861,559,17,17,0,542
76862,17,0,0,0,17
76864,154,0,0,0,154
76865,9,0,0,0,9
76866,70,8,0,0,62
76869,12,0,0,0,12
76870,53,7,0,0,46
76871,104,14,0,0,90
76872,82,0,0,0,82
76873,0,0,0,0,0
76874,0,0,0,0,0
76875,188,0,0,0,188
76877,781,40,15,4,741
76878,364,16,13,13,348
76882,5,0,0,0,5
76884,59,2,2,0,57
76885,89,0,0,0,89
76887,0,0,0,0,0
76888,10,4,4,0,6
76890,192,16,0,0,176
76901,6501,358,74,0,6143
76903,7802,561,198,42,7241
76904,8193,441,108,0,7752
76905,3578,146,42,0,3432
76908,683,0,0,0,683
76930,33,0,0,0,33
76932,836,28,8,8,808
76933,263,5,0,0,258
76934,219,0,0,0,219
76935,340,7,7,0,333
76936,699,35,9,9,664
76937,9,0,0,0,9
76939,14,0,0,0,14
76940,34,1,0,0,33
76941,292,19,6,0,273
76943,752,41,0,0,711
76945,240,0,0,0,240
76949,2,0,0,0,2
76950,865,55,6,0,810
76951,229,6,0,0,223
76953,11,0,0,0,11
76955,15,0,0,0,15
76957,0,0,0,0,0
76958,68,3,3,0,65
77002,1647,88,71,0,1559
77003,2936,198,86,33,2738
77004,11835,312,186,0,11523
77005,6274,313,18,0,5961
77006,6401,247,58,0,6154
77007,10761,339,15,0,10422
77008,8848,639,126,0,8209
77009,9892,591,294,70,9301
77010,272,0,0,0,272
77011,4123,162,112,0,3961
77012,5067,419,214,22,4648
77013,5083,408,207,4,4675
77014,9591,636,213,49,8955
77015,14661,1158,453,60,13503
77016,6413,253,116,20,6160
77017,8570,555,165,4,8015
77018,6500,436,68,37,6064
77019,6171,194,41,8,5977
77020,5915,459,213,55,5456
77021,7041,449,213,43,6592
77022,6990,446,295,45,6544
77023,7196,416,182,29,6780
77024,7928,286,23,0,7642
77025,7511,451,63,8,7060
77026,5618,415,222,38,5203
77027,5289,199,43,0,5090
77028,3078,187,107,20,2891
77029,4010,234,82,18,3776
77030,3167,104,0,0,3063
77031,4799,415,185,81,4384
77032,3612,284,150,21,3328
77033,6359,424,289,65,5935
77034,10835,728,338,50,10107
77035,9963,509,228,7,9454
77036,18514,1415,552,50,17099
77037,5555,398,277,55,5157
77038,7637,431,285,37,7206
77039,7737,647,355,78,7090
77040,12579,703,232,29,11876
77041,9284,306,149,0,8978
77042,11664,559,89,0,11105
77043,5984,337,84,67,5647
77044,10078,716,238,85,9362
77045,9161,340,132,53,8821
77046,263,21,0,0,242
77047,7314,419,121,40,6895
77048,4215,269,154,13,3946
77049,8814,309,135,53,8505
77050,1198,36,36,9,1162
77051,3531,415,236,18,3116
77053,8044,662,314,92,7382
77054,7847,249,59,0,7598
77055,10390,770,226,30,9620
77056,4665,243,15,0,4422
77057,10576,880,414,80,9696
77058,4290,114,37,16,4176
77059,3898,205,28,0,3693
77060,12425,1514,1074,234,10911
77061,6526,340,135,101,6186
77062,6401,345,110,0,6056
77063,9847,851,202,0,8996
77064,12218,338,84,23,11880
77065,10578,556,244,6,10022
77066,8633,507,123,7,8126
77067,9709,593,328,40,9116
77068,2570,85,0,0,2485
77069,3580,212,24,0,3368
77070,13358,861,331,9,12497
77071,7813,532,203,0,7281
77072,15506,880,403,0,14626
77073,11496,1107,382,66,10389
77074,9074,703,213,0,8371
77075,12098,721,407,9,11377
77076,9123,803,448,49,8320
77077,15678,723,99,0,14955
77078,4426,385,193,40,4041
77079,7382,221,21,14,7161
77080,11479,793,391,85,10686
77081,12002,876,358,81,11126
77082,16654,675,155,0,15979
77083,20303,1184,301,62,19119
77084,28333,1621,605,124,26712
77085,4523,155,96,0,4368
77086,7559,521,266,37,7038
77087,9290,628,192,48,8662
77088,13593,1058,566,40,12535
77089,13942,571,131,0,13371
77090,11276,887,472,67,10389
77091,5987,514,277,33,5473
77092,9309,700,279,82,8609
77093,10414,763,372,46,9651
77094,2151,172,8,0,1979
77095,19773,1182,391,37,18591
77096,8237,525,89,0,7712
77098,3999,71,2,0,3928
77099,12415,632,296,49,11783
77201,0,0,0,0,0
77301,8022,346,117,0,7676
77302,4274,470,165,0,3804
77303,5222,193,37,7,5029
77304,6171,291,167,0,5880
77306,3006,181,83,0,2825
77316,4179,420,174,0,3759
77318,2657,24,0,0,2633
77320,6206,286,148,103,5920
77326,0,0,0,0,0
77327,5188,310,207,5,4878
77328,3739,158,39,0,3581
77331,1055,114,109,109,941
77334,0,0,0,0,0
77335,484,0,0,0,484
77336,3172,123,0,0,3049
77338,10080,958,297,50,9122
77339,9557,568,210,39,8989
77340,8740,283,122,45,8457
77342,0,0,0,0,0
77345,6801,222,12,0,6579
77346,16246,940,396,28,15306
77350,24,5,5,5,19
77351,5632,479,369,57,5153
77354,8113,476,0,0,7637
77355,6633,234,88,32,6399
77356,4823,160,90,0,4663
77357,5167,369,201,26,4798
77358,1093,50,7,0,1043
77359,104,0,0,0,104
77360,940,22,14,0,918
77362,1262,104,85,0,1158
77363,539,8,0,0,531
77364,226,21,0,0,205
77365,7130,446,0,0,6684
77367,42,0,0,0,42
77368,0,0,0,0,0
77369,130,0,0,0,130
77371,1862,100,10,0,1762
77372,3009,211,124,34,2798
77373,15052,878,245,52,14174
77374,83,0,0,0,83
77375,10298,749,181,78,9549
77376,149,38,38,38,111
77377,7954,634,156,72,7320
77378,3330,117,16,0,3213
77379,18002,878,84,0,17124
77380,7150,510,59,59,6640
77381,8224,398,16,0,7826
77382,9040,290,1,0,8750
77384,3144,235,83,0,2909
77385,6155,260,98,0,5895
77386,11322,1311,124,8,10011
77388,10481,667,174,0,9814
77389,6427,511,42,0,5916
77396,13518,997,133,44,12521
77401,3941,357,61,21,3584
77406,7672,746,59,0,6926
77407,11077,725,48,0,10352
77412,27,0,0,0,27
77414,5203,429,144,25,4774
77415,19,0,0,0,19
77417,582,18,0,0,564
77418,1993,138,61,0,1855
77419,215,9,0,0,206
77420,464,0,0,0,464
77422,2586,178,78,10,2408
77423,2347,272,127,127,2075
77426,225,0,0,0,225
77428,0,0,0,0,0
77429,20889,958,158,10,19931
77430,535,47,0,0,488
77432,17,0,0,0,17
77433,16371,888,160,18,15483
77434,1293,51,21,0,1242
77435,1229,41,9,0,1188
77436,0,0,0,0,0
77437,3706,177,64,8,3529
77440,0,0,0,0,0
77441,1335,70,17,0,1265
77442,146,0,0,0,146
77443,0,0,0,0,0
77444,207,0,0,0,207
77445,2629,34,1,0,2595
77446,3734,17,6,0,3717
77447,3360,204,25,0,3156
77448,0,0,0,0,0
77449,29454,1591,612,0,27863
77450,19849,931,69,0,18918
77451,8,0,0,0,8
77453,98,29,0,0,69
77454,0,0,0,0,0
77455,341,10,0,0,331
77456,253,0,0,0,253
77457,58,0,0,0,58
77458,0,0,0,0,0
77459,15725,694,80,70,15031
77460,26,0,0,0,26
77461,2466,53,0,0,2413
77464,51,13,8,8,38
77465,1620,162,115,0,1458
77466,89,2,0,0,87
77467,14,14,14,0,0
77468,10,0,0,0,10
77469,10516,497,226,45,10019
77470,49,29,0,0,20
77471,9686,626,342,56,9060
77473,26,0,0,0,26
77474,2968,94,8,8,2874
77475,81,0,0,0,81
77476,15,0,0,0,15
77477,9995,359,112,17,9636
77478,5070,257,14,0,4813
77479,20906,1100,5,0,19806
77480,1601,101,92,0,1500
77481,4,0,0,0,4
77482,699,123,0,0,576
77483,123,0,0,0,123
77484,2550,214,92,37,2336
77485,874,38,23,0,836
77486,1653,72,22,0,1581
77488,3140,253,165,5,2887
77489,9147,475,253,25,8672
77493,6806,440,136,0,6366
77494,24159,1085,91,0,23074
77498,13399,628,150,0,12771
77502,9412,719,231,12,8693
77503,6478,301,173,17,6177
77504,5803,553,122,20,5250
77505,6021,295,83,31,5726
77506,8835,647,320,35,8188
77507,0,0,0,0,0
77510,3001,94,35,0,2907
77511,10864,738,400,28,10126
77514,845,52,15,0,793
77515,6883,391,273,20,6492
77517,1279,58,40,0,1221
77518,2154,138,0,0,2016
77519,345,73,0,0,272
77520,9270,602,270,59,8668
77521,13243,581,305,68,12662
77523,5455,399,72,0,5056
77530,7677,335,109,30,7342
77531,4015,344,143,0,3671
77532,7188,481,209,17,6707
77533,145,6,0,0,139
77534,795,18,0,0,777
77535,9390,501,224,52,8889
77536,8086,519,162,32,7567
77538,241,13,4,4,228
77539,10290,753,262,75,9537
77541,4573,266,100,30,4307
77545,6878,320,149,0,6558
77546,12367,414,39,0,11953
77547,2792,128,11,0,2664
77550,5818,243,121,33,5575
77551,4908,303,162,59,4605
77554,1855,33,23,0,1822
77560,200,10,10,0,190
77561,7,0,0,0,7
77562,2317,88,52,0,2229
77563,2031,108,68,10,1923
77564,387,40,0,0,347
77565,1523,3,0,0,1520
77566,7228,512,338,130,6716
77568,3231,245,184,7,2986
77571,8656,605,175,33,8051
77573,20419,987,86,0,19432
77575,3305,242,52,0,3063
77577,250,2,0,0,248
77578,4492,257,0,0,4235
77580,127,0,0,0,127
77581,10794,802,141,21,9992
77583,6378,542,38,8,5836
77584,21361,1293,155,25,20068
77585,300,15,0,0,285
77586,5383,262,65,21,5121
77587,4142,323,138,0,3819
77590,6977,426,207,8,6551
77591,3293,233,65,0,3060
77597,195,0,0,0,195
77598,6831,428,201,36,6403
77611,1890,100,26,0,1790
77612,1942,43,0,0,1899
77613,228,0,0,0,228
77614,184,0,0,0,184
77615,160,0,0,0,160
77616,100,0,0,0,100
77617,15,0,0,0,15
77619,3591,170,80,15,3421
77622,357,17,0,0,340
77623,84,23,20,0,61
77624,157,0,0,0,157
77625,1722,93,41,4,1629
77627,4974,193,0,0,4781
77629,128,0,0,0,128
77630,6182,395,300,25,5787
77632,5674,238,144,102,5436
77640,3521,157,70,5,3364
77642,9398,875,423,42,8523
77650,216,0,0,0,216
77651,2788,104,0,0,2684
77655,78,5,1,0,73
77656,3789,282,150,92,3507
77657,5016,185,39,39,4831
77659,1114,4,0,0,1110
77660,306,59,0,0,247
77661,330,0,0,0,330
77662,6485,427,208,15,6058
77663,91,0,0,0,91
77664,617,24,24,0,593
77665,1272,56,55,55,1216
77701,3390,135,70,35,3255
77702,621,21,0,0,600
77703,3971,163,103,64,3808
77705,7168,464,263,22,6704
77706,6418,356,138,0,6062
77707,4224,342,145,46,3882
77708,3113,236,84,42,2877
77713,3286,101,32,0,3185
77801,4823,225,87,15,4598
77802,6440,337,100,0,6103
77803,8247,761,387,50,7486
77807,2562,135,81,55,2427
77808,2469,356,87,27,2113
77830,689,23,21,0,666
77831,540,37,0,0,503
77833,6806,371,186,102,6435
77835,266,10,0,0,256
77836,2394,119,17,0,2275
77837,489,0,0,0,489
77840,22994,534,178,4,22460
77845,14960,606,9,8,14354
77853,310,2,2,0,308
77855,9,0,0,0,9
77856,891,59,22,0,832
77857,178,18,3,0,160
77859,1525,53,13,13,1472
77861,524,35,0,0,489
77864,1565,125,37,3,1440
77865,135,4,0,0,131
77867,8,0,0,0,8
77868,2918,81,39,0,2837
77871,446,20,20,3,426
77872,326,55,24,4,271
77873,279,0,0,0,279
77876,15,0,0,0,15
77878,127,0,0,0,127
77879,952,9,5,0,943
77880,159,0,0,0,159
77901,10630,834,470,90,9796
77904,5583,214,140,4,5369
77905,3069,147,43,0,2922
77950,54,2,0,0,52
77951,381,0,0,0,381
77954,2301,84,51,13,2217
77957,1753,90,62,19,1663
77960,0,0,0,0,0
77961,24,0,0,0,24
77962,718,52,20,9,666
77963,1117,74,11,0,1043
77964,1625,97,18,0,1528
77968,669,61,7,0,608
77969,34,0,0,0,34
77970,59,4,0,0,55
77971,252,0,0,0,252
77973,22,0,0,0,22
77974,109,0,0,0,109
77975,361,10,0,0,351
77976,18,0,0,0,18
77977,235,6,0,0,229
77978,131,9,5,0,122
77979,4031,279,109,14,3752
77982,158,16,0,0,142
77983,527,46,35,8,481
77984,703,20,12,12,683
77987,67,0,0,0,67
77988,82,10,0,0,72
77990,160,2,0,0,158
77991,96,13,13,0,83
77993,37,0,0,0,37
77994,70,0,0,0,70
77995,1778,101,31,6,1677
78001,0,0,0,0,0
78002,1960,136,40,25,1824
78003,1481,64,0,0,1417
78004,306,37,0,0,269
78005,77,0,0,0,77
78006,6489,154,67,0,6335
78007,16,0,0,0,16
78008,47,34,0,0,13
78009,1935,176,45,0,1759
78010,510,58,0,0,452
78011,442,37,17,0,405
78012,104,13,7,7,91
78013,1115,96,7,0,1019
78014,1002,143,71,28,859
78015,2568,124,0,0,2444
78016,2012,138,53,0,1874
78017,713,21,12,9,692
78019,415,24,21,0,391
78021,83,0,0,0,83
78022,1114,85,39,0,1029
78023,7193,215,33,0,6978
78024,162,6,0,0,156
78025,773,30,12,0,743
78026,1252,43,0,0,1209
78027,65,0,0,0,65
78028,7791,411,229,18,7380
78029,0,0,0,0,0
78039,442,9,0,0,433
78040,9906,600,312,38,9306
78041,11381,655,329,52,10726
78043,11991,743,371,97,11248
78044,26,9,0,0,17
78045,16746,1204,302,36,15542
78046,17806,1478,516,162,16328
78050,147,0,0,0,147
78052,1615,0,0,0,1615
78055,316,0,0,0,316
78056,267,30,0,0,237
78057,178,25,25,0,153
78058,146,10,0,0,136
78059,1384,195,30,3,1189
78060,0,0,0,0,0
78061,2523,257,193,30,2266
78063,1685,168,50,0,1517
78064,3494,210,20,0,3284
78065,2465,183,95,0,2282
78066,85,0,0,0,85
78067,130,0,0,0,130
78069,1439,58,22,4,1381
78070,3024,205,84,0,2819
78071,704,103,59,0,601
78072,109,7,0,0,102
78073,2007,183,89,2,1824
78075,9,0,0,0,9
78076,3323,337,106,0,2986
78101,1844,57,13,0,1787
78102,4815,423,38,10,4392
78104,14,10,10,0,4
78107,115,0,0,0,115
78108,9448,654,122,42,8794
78109,9908,731,240,18,9177
78112,1787,134,63,10,1653
78113,618,35,0,0,583
78114,4455,374,274,15,4081
78116,47,11,0,0,36
78117,130,0,0,0,130
78118,669,71,46,0,598
78119,973,106,52,0,867
78121,2591,69,19,0,2522
78122,77,0,0,0,77
78123,488,30,0,0,458
78124,1234,42,15,0,1192
78125,3,0,0,0,3
78130,15942,918,443,45,15024
78132,5250,279,126,23,4971
78133,3187,130,12,0,3057
78140,812,34,0,0,778
78141,134,0,0,0,134
78142,42,0,0,0,42
78143,225,0,0,0,225
78144,0,0,0,0,0
78145,13,5,0,0,8
78146,151,15,11,0,136
78147,522,17,10,0,505
78148,5002,453,227,5,4549
78150,0,0,0,0,0
78151,327,33,23,7,294
78152,527,13,10,0,514
78154,8984,606,289,19,8378
78155,10599,386,69,25,10213
78159,199,4,4,4,195
78160,929,59,21,0,870
78161,141,0,0,0,141
78162,76,0,0,0,76
78163,2006,173,0,0,1833
78164,554,58,53,0,496
78201,10321,583,289,17,9738
78202,3034,199,145,25,2835
78203,1321,116,82,31,1205
78204,2613,190,96,49,2423
78205,148,0,0,0,148
78207,12151,880,560,63,11271
78208,971,94,45,11,877
78209,9478,490,76,0,8988
78210,9613,715,343,54,8898
78211,8116,626,246,57,7490
78212,7129,398,241,17,6731
78213,11474,629,260,49,10845
78214,6155,383,117,0,5772
78215,537,13,0,0,524
78216,10318,617,363,113,9701
78217,8811,397,225,35,8414
78218,9202,511,295,66,8691
78219,3926,314,197,52,3612
78220,3441,259,204,20,3182
78221,8926,721,283,64,8205
78222,5938,522,222,56,5416
78223,12921,690,285,72,12231
78224,4949,207,59,0,4742
78225,3532,188,65,7,3344
78226,1412,55,28,0,1357
78227,12274,979,649,121,11295
78228,15314,929,434,36,14385
78229,9669,396,163,41,9273
78230,11428,565,202,41,10863
78231,1940,50,0,0,1890
78232,8875,416,84,0,8459
78233,11894,605,238,0,11289
78234,2151,110,0,0,2041
78235,333,22,5,5,311
78236,1607,30,0,0,1577
78237,8923,471,331,41,8452
78238,7143,213,41,0,6930
78239,6632,270,156,37,6362
78240,15298,919,157,9,14379
78242,9194,715,287,30,8479
78243,18,0,0,0,18
78244,8379,382,135,21,7997
78245,17198,1430,355,97,15768
78247,14003,773,103,37,13230
78248,3202,145,20,0,3057
78249,16696,643,244,49,16053
78250,15580,854,192,59,14726
78251,16407,1167,296,1,15240
78252,1807,105,61,0,1702
78253,9237,799,72,0,8438
78254,13939,1153,257,15,12786
78255,3262,134,0,0,3128
78256,2597,95,0,0,2502
78257,1000,123,16,0,877
78258,11491,561,74,0,10930
78259,6033,303,9,0,5730
78260,7447,339,36,0,7108
78261,3831,239,0,0,3592
78263,1036,21,21,0,1015
78264,2504,111,6,6,2393
78266,1234,88,25,0,1146
78330,182,19,13,0,163
78332,6693,502,140,43,6191
78335,0,0,0,0,0
78336,2660,257,126,8,2403
78338,4,0,0,0,4
78339,178,0,0,0,178
78340,55,0,0,0,55
78341,425,19,0,0,406
78342,62,0,0,0,62
78343,1024,86,51,0,938
78344,93,9,9,0,84
78349,49,0,0,0,49
78351,111,7,7,0,104
78352,112,0,0,0,112
78353,60,0,0,0,60
78355,1468,109,93,0,1359
78357,783,63,38,0,720
78358,110,12,12,0,98
78359,430,35,7,0,395
78361,898,155,117,8,743
78362,2241,139,72,0,2102
78363,7737,407,201,13,7330
78368,2189,195,131,60,1994
78369,59,8,8,0,51
78370,1038,99,46,0,939
78371,61,7,7,0,54
78372,1696,203,61,0,1493
78373,916,13,0,0,903
78374,4422,369,88,28,4053
78375,481,20,20,0,461
78376,138,42,0,0,96
78377,798,101,83,8,697
78379,272,13,5,0,259
78380,5244,241,92,0,5003
78382,3526,290,69,22,3236
78383,416,0,0,0,416
78384,1357,101,50,50,1256
78385,68,7,0,0,61
78387,2299,299,231,16,2000
78389,326,38,15,0,288
78390,1077,81,25,19,996
78391,81,0,0,0,81
78393,448,17,4,0,431
78401,1156,102,64,0,1054
78402,53,0,0,0,53
78404,3957,241,155,16,3716
78405,3644,302,199,55,3342
78406,184,36,6,0,148
78407,699,32,6,6,667
78408,2860,205,155,19,2655
78409,799,95,40,0,704
78410,6488,331,81,11,6157
78411,6590,380,260,0,6210
78412,10382,605,282,37,9777
78413,9826,639,186,0,9187
78414,9829,513,126,30,9316
78415,9706,375,218,46,9331
78416,3389,222,112,64,3167
78417,979,90,9,4,889
78418,6722,362,206,0,6360
78419,254,20,13,0,234
78501,16321,971,311,163,15350
78503,5821,343,160,49,5478
78504,13797,737,112,0,13060
78516,8172,429,151,53,7743
78520,16013,1001,353,127,15012
78521,23482,1496,619,250,21986
78526,12213,575,44,0,11638
78535,118,20,0,0,98
78536,91,23,16,0,68
78537,10137,712,251,26,9425
78538,2997,195,71,7,2802
78539,8470,574,199,15,7896
78541,12744,794,169,0,11950
78542,16937,1275,398,67,15662
78543,2434,42,35,0,2392
78545,68,15,5,5,53
78548,117,0,0,0,117
78549,82,9,0,0,73
78550,11728,823,336,33,10905
78552,8559,595,288,0,7964
78557,3245,230,59,17,3015
78558,265,0,0,0,265
78559,2867,76,50,0,2791
78560,1016,114,37,0,902
78561,213,6,6,0,207
78562,875,54,38,14,821
78563,18,0,0,0,18
78564,0,0,0,0,0
78565,34,0,0,0,34
78566,4635,307,54,20,4328
78567,169,13,10,0,156
78569,1038,77,10,0,961
78570,8039,597,111,26,7442
78572,18400,1233,201,97,17167
78573,9293,974,407,55,8319
78574,17538,1361,481,124,16177
78575,2616,137,22,0,2479
78576,2343,249,79,0,2094
78577,19175,1202,341,37,17973
78578,2344,233,113,65,2111
78579,1289,48,0,0,1241
78580,2912,125,15,0,2787
78582,10384,714,314,24,9670
78583,1376,80,42,0,1296
78584,4712,174,39,2,4538
78585,86,0,0,0,86
78586,13840,826,576,105,13014
78588,56,0,0,0,56
78589,9667,585,220,81,9082
78590,88,0,0,0,88
78591,81,0,0,0,81
78592,234,9,0,0,225
78593,1517,142,48,20,1375
78594,363,17,0,0,346
78595,1760,141,55,18,1619
78596,16218,1267,453,59,14951
78597,388,0,0,0,388
78598,0,0,0,0,0
78602,4958,410,47,27,4548
78605,1209,36,0,0,1173
78606,1100,38,5,0,1062
78607,0,0,0,0,0
78608,106,0,0,0,106
78609,204,0,0,0,204
78611,2652,147,90,90,2505
78614,33,0,0,0,33
78616,1167,134,84,0,1033
78618,38,2,2,0,36
78619,697,10,0,0,687
78622,63,6,0,0,57
78623,131,0,0,0,131
78624,3736,247,97,30,3489
78629,2607,185,72,13,2422
78631,377,6,0,0,371
78632,136,23,0,0,113
78635,0,0,0,0,0
78636,665,40,0,0,625
78638,521,0,0,0,521
78639,1253,102,52,14,1151
78640,11834,742,275,64,11092
78643,979,43,26,0,936
78644,4408,182,120,10,4226
78648,1805,74,14,0,1731
78650,537,22,3,0,515
78655,927,74,56,39,853
78656,604,10,0,0,594
78657,815,20,0,0,795
78659,721,4,0,0,717
78661,108,0,0,0,108
78662,729,21,0,0,708
78666,24898,709,392,40,24189
78670,29,0,0,0,29
78671,125,14,0,0,111
78672,138,0,0,0,138
78675,0,0,0,0,0
78676,1886,52,10,0,1834
78677,8,0,0,0,8
78801,4833,537,276,17,4296
78802,380,27,27,27,353
78827,326,31,22,0,295
78828,44,0,0,0,44
78829,367,40,40,32,327
78830,107,19,0,0,88
78832,609,0,0,0,609
78833,253,38,15,0,215
78834,1919,10,10,0,1909
78836,8,0,0,0,8
78837,26,12,0,0,14
78838,13,0,0,0,13
78839,1936,76,23,0,1860
78840,10977,693,225,99,10284
78843,53,0,0,0,53
78850,289,14,0,0,275
78851,3,0,0,0,3
78852,13232,1121,433,72,12111
78860,56,9,0,0,47
78861,2553,314,241,45,2239
78870,249,6,6,6,243
78871,0,0,0,0,0
78872,518,24,24,8,494
78873,268,11,4,0,257
78877,153,0,0,0,153
78879,0,0,0,0,0
78880,386,7,0,0,379
78881,465,55,46,26,410
78883,37,0,0,0,37
78884,188,0,0,0,188
78885,0,0,0,0,0
78886,52,0,0,0,52
78931,8,0,0,0,8
78932,92,16,16,0,76
78933,99,0,0,0,99
78934,1130,54,0,0,1076
78935,333,0,0,0,333
78938,122,0,0,0,122
78940,330,11,0,0,319
78941,734,36,19,0,698
78942,1890,225,170,77,1665
78943,17,0,0,0,17
78944,96,0,0,0,96
78945,1932,57,28,28,1875
78946,129,0,0,0,129
78947,807,63,33,33,744
78948,175,0,0,0,175
78949,131,23,0,0,108
78950,564,33,0,0,531
78951,0,0,0,0,0
78953,209,0,0,0,209
78954,139,4,0,0,135
78956,924,82,31,3,842
78957,2078,62,10,0,2016
78959,392,12,0,0,380
78962,1016,98,36,0,918
78963,230,0,0,0,230
79001,47,0,0,0,47
79003,62,3,0,0,59
79005,370,44,3,0,326
79007,3280,225,100,36,3055
79009,533,40,0,0,493
79010,103,14,7,7,89
79011,57,13,0,0,44
79012,261,0,0,0,261
79013,926,136,122,43,790
79014,849,49,13,0,800
79015,6526,360,189,0,6166
79016,112,0,0,0,112
79018,85,3,3,0,82
79019,354,11,0,0,343
79021,26,2,0,0,24
79022,2285,255,42,34,2030
79024,96,5,3,0,91
79025,9,0,0,0,9
79027,1035,79,18,0,956
79029,3757,382,105,44,3375
79031,264,4,2,2,260
79032,30,0,0,0,30
79033,4,0,0,0,4
79034,154,8,8,0,146
79035,1037,84,4,0,953
79036,1059,59,11,0,1000
79039,147,4,0,0,143
79040,347,38,0,0,309
79041,699,51,11,0,648
79042,317,0,0,0,317
79043,366,10,7,7,356
79044,179,0,0,0,179
79045,4500,418,159,0,4082
79046,107,13,8,8,94
79051,18,0,0,0,18
79052,229,12,0,0,217
79053,42,0,0,0,42
79054,54,0,0,0,54
79056,7,3,0,0,4
79057,290,16,10,10,274
79058,0,0,0,0,0
79059,172,8,0,0,164
79061,95,5,0,0,90
79062,60,6,0,0,54
79063,140,24,7,0,116
79064,407,29,8,0,378
79065,4330,320,110,12,4010
79068,705,60,12,0,645
79070,2479,248,110,22,2231
79072,6156,423,113,14,5733
79078,38,0,0,0,38
79079,488,15,0,0,473
79080,99,6,2,0,93
79081,905,54,0,0,851
79082,46,0,0,0,46
79083,452,56,10,0,396
79084,566,49,2,0,517
79085,0,0,0,0,0
79086,458,20,0,0,438
79087,121,3,0,0,118
79088,993,93,76,0,900
79091,35,0,0,0,35
79092,214,16,0,0,198
79093,18,0,0,0,18
79094,0,0,0,0,0
79095,519,25,4,0,494
79096,436,51,13,0,385
79097,298,19,0,0,279
79098,123,1,0,0,122
79101,487,48,35,0,439
79102,2503,227,76,34,2276
79103,2715,218,140,15,2497
79104,1410,15,15,0,1395
79105,0,0,0,0,0
79106,6797,340,75,5,6457
79107,9089,892,479,105,8197
79108,2602,126,39,17,2476
79109,10075,439,165,17,9636
79110,5279,369,174,0,4910
79111,440,25,9,0,415
79118,4391,183,30,0,4208
79119,3431,219,27,0,3212
79121,1126,43,0,0,1083
79124,1731,66,0,0,1665
79201,1203,146,44,0,1057
79220,62,3,0,0,59
79225,215,3,0,0,212
79226,589,2,1,0,587
79227,195,49,45,45,146
79229,40,0,0,0,40
79230,20,1,0,0,19
79231,0,0,0,0,0
79233,9,0,0,0,9
79234,11,11,0,0,0
79235,784,32,0,0,752
79236,52,3,0,0,49
79237,84,0,0,0,84
79239,21,0,0,0,21
79240,9,0,0,0,9
79241,512,30,8,0,482
79243,9,0,0,0,9
79244,113,4,0,0,109
79245,486,51,47,47,435
79247,10,3,0,0,7
79248,233,21,0,0,212
79250,363,36,16,0,327
79251,2,0,0,0,2
79252,698,97,12,0,601
79255,156,6,3,0,150
79256,73,8,0,0,65
79257,213,7,0,0,206
79258,6,0,0,0,6
79259,18,0,0,0,18
79261,101,0,0,0,101
79311,923,77,47,37,846
79312,294,16,6,0,278
79313,344,43,36,14,301
79314,11,4,0,0,7
79316,2129,52,22,0,2077
79322,373,23,11,0,350
79323,1586,75,37,0,1511
79324,0,0,0,0,0
79325,500,28,0,0,472
79326,0,0,0,0,0
79329,717,81,0,0,636
79330,61,0,0,0,61
79331,2397,248,105,0,2149
79336,4162,260,65,44,3902
79339,1494,123,56,19,1371
79342,88,1,0,0,87
79343,370,0,0,0,370
79344,26,0,0,0,26
79345,194,7,3,3,187
79346,459,37,17,7,422
79347,1529,41,4,0,1488
79350,67,17,9,0,50
79351,310,14,2,0,296
79353,20,0,0,0,20
79355,441,40,8,0,401
79356,882,12,3,0,870
79357,526,28,19,5,498
79358,177,12,8,2,165
79359,549,57,37,0,492
79360,3548,141,0,0,3407
79363,1281,103,17,14,1178
79364,1735,146,29,12,1589
79366,231,3,0,0,228
79367,253,31,0,0,222
79369,33,0,0,0,33
79370,285,23,5,0,262
79371,274,18,5,0,256
79372,359,5,5,0,354
79373,707,26,17,0,681
79376,26,5,0,0,21
79377,68,4,0,0,64
79378,140,2,0,0,138
79379,196,8,5,3,188
79380,65,0,0,0,65
79381,281,7,3,0,274
79382,1364,181,50,0,1183
79401,2808,58,15,0,2750
79403,4024,252,175,84,3772
79404,2682,208,111,0,2474
79406,3084,9,9,0,3075
79407,4927,129,45,0,4798
79410,2748,54,4,4,2694
79411,2451,97,42,0,2354
79412,4182,282,153,49,3900
79413,5650,344,104,0,5306
79414,5474,245,139,42,5229
79415,4557,328,212,73,4229
79416,9239,412,206,93,8827
79423,8661,557,133,9,8104
79424,10708,599,106,0,10109
79501,795,87,16,0,708
79502,184,22,1,0,162
79503,31,8,8,0,23
79504,679,25,8,0,654
79505,56,3,0,0,53
79506,139,7,0,0,132
79508,366,19,4,4,347
79510,1528,130,125,9,1398
79511,264,60,7,0,204
79512,1202,25,2,0,1177
79517,39,7,0,0,32
79518,11,0,0,0,11
79519,27,0,0,0,27
79520,490,30,30,0,460
79521,564,20,20,10,544
79525,304,15,0,0,289
79526,179,5,0,0,174
79527,40,9,0,0,31
79528,108,23,4,0,85
79529,328,15,0,0,313
79530,83,2,2,0,81
79532,155,14,9,0,141
79533,43,1,0,0,42
79534,6,0,0,0,6
79535,5,0,0,0,5
79536,1080,9,0,0,1071
79537,7,0,0,0,7
79538,22,0,0,0,22
79539,19,0,0,0,19
79540,7,0,0,0,7
79541,214,0,0,0,214
79543,214,3,3,0,211
79544,76,0,0,0,76
79545,401,29,0,0,372
79546,386,41,11,5,345
79547,125,13,0,0,112
79548,29,0,0,0,29
79549,3320,189,36,4,3131
79553,873,18,0,0,855
79556,2723,202,148,13,2521
79560,8,0,0,0,8
79561,130,6,6,0,124
79562,808,38,3,0,770
79563,280,16,16,0,264
79565,59,2,2,0,57
79566,29,25,25,0,4
79567,604,12,4,0,592
79601,6495,250,75,24,6245
79602,5515,439,155,0,5076
79603,5658,410,209,63,5248
79605,7072,395,105,39,6677
79606,5734,394,64,0,5340
79607,742,144,5,0,598
79699,111,0,0,0,111
79701,7580,595,278,67,6985
79703,6481,472,119,14,6009
79705,8112,585,100,0,7527
79706,4985,212,60,0,4773
79707,8897,679,201,28,8218
79713,90,7,0,0,83
79714,3914,422,151,42,3492
79718,142,7,4,0,135
79719,121,0,0,0,121
79720,6770,453,240,42,6317
79730,67,0,0,0,67
79731,1011,127,57,34,884
79733,65,0,0,0,65
79734,328,0,0,0,328
79735,2489,122,29,29,2367
79738,65,7,0,0,58
79739,183,5,0,0,178
79741,73,3,0,0,70
79742,78,4,0,0,74
79743,84,12,11,5,72
79744,320,32,19,14,288
79745,1551,111,49,0,1440
79748,17,3,3,0,14
79749,56,8,0,0,48
79752,560,74,25,21,486
79754,3,0,0,0,3
79755,30,0,0,0,30
79756,2198,155,39,39,2043
79758,325,0,0,0,325
79759,7,0,0,0,7
79761,8350,869,489,50,7481
79762,10315,1189,302,115,9126
79763,8378,869,319,6,7509
79764,5307,428,242,0,4879
79765,2848,354,59,24,2494
79766,1872,235,102,37,1637
79770,14,0,0,0,14
79772,2400,208,75,21,2192
79777,56,0,0,0,56
79778,174,6,4,0,168
79780,69,0,0,0,69
79781,50,0,0,0,50
79782,1074,10,10,0,1064
79783,56,4,0,0,52
79785,37,14,10,0,23
79788,92,22,0,0,70
79789,296,21,8,0,275
79821,1418,78,66,2,1340
79830,1698,27,2,0,1671
79831,0,0,0,0,0
79834,41,0,0,0,41
79835,3319,304,74,0,3015
79836,1118,74,45,0,1044
79837,79,0,0,0,79
79838,2062,153,153,72,1909
79839,399,40,24,17,359
79842,112,4,4,4,108
79843,417,42,0,0,375
79845,1083,42,11,0,1041
79846,18,12,0,0,6
79847,0,0,0,0,0
79848,175,6,0,0,169
79849,3092,207,88,0,2885
79851,200,13,8,5,187
79852,135,5,0,0,130
79853,867,46,46,19,821
79854,9,0,0,0,9
79855,546,25,21,0,521
79901,2184,86,44,0,2098
79902,5248,212,99,0,5036
79903,3218,205,142,0,3013
79904,8444,552,175,74,7892
79905,5596,288,193,30,5308
79906,1214,240,106,0,974
79907,13146,929,323,110,12217
79908,696,16,0,0,680
79911,1219,44,0,0,1175
79912,20029,982,384,72,19047
79915,8737,524,299,78,8213
79916,447,0,0,0,447
79920,0,0,0,0,0
79922,1977,89,30,0,1888
79924,14767,912,354,85,13855
79925,9719,688,259,48,9031
79927,10255,425,191,27,9830
79928,14955,798,309,63,14157
79930,7266,285,138,43,6981
79932,7331,440,159,23,6891
79934,6774,547,60,0,6227
79935,4607,178,147,16,4429
79936,30430,1464,519,123,28966
79938,18546,983,107,22,17563
79942,0,0,0,0,0
88063,4074,215,108,38,3859
88220,7268,753,526,153,6515
88430,3,0,0,0,3